############
##      B###
# A#########
# A        #
############