      #######             
  ### #B #  #              ####
  # ###  #  #              #  #
  #     ## #################  #
  #         #               A #
 ##  #####  # ############    #
 #   #   # ## #          #    #
 #   #   #    #          ######
 #####   ######