############
##      B###
#  #########
#       A  #
############