############
## A    B###
#  #########
#          #
############