############
##......B###
# .#########
# ........A#
############
